4444444444444442222224444
4000000000000000000000004
4000000000000000000000004
2000066666666666666000004
2000060000000000006000004
2000060000000000006000004
2000000000000000000000004
4000060000000000006000004
4000060000000000006000004
4000066666666666666000004
4000000000000000000000004
4000000000000000000000004
4444444444444444444444444