ffffffffffffffffff66666666
f00000000e0000000060000006
f0000e00000000e0000000006f
f000000000000000000660066f
f000000e00000000000000e00f
fe00000000000e00000000000f
f000e00000000000000000e00f
f000000000000ee0000000000f
f0000e0000000000000000e00f
f0000000000e0000000000000f
f00e0000000e000000e000000f
f000000000000000000000e00f
ffffffffffffffffffffffffff