77777777777777777777777777
70000000000000000000000007
70001111111111111111110007
70001000000000000000010007
70001005533355333530010007
70001005000000000030010007
70001005000000000030010007
70001003000000000030010007
70001003353300555330010007
70001000000000000000010007
70001111111000011111110007
70000000000000000000000007
77777777777777777777777777