22222222444448888888abbbbb
20000000000008000004000009
24404444880088080004000006
90000084000008080000000006
24400084088888088888000882
90000444000000000000000002
24400084000000000000000002
90000084088888088888000882
24404444000008080000000882
28800000000008088888000882
80000888000008000000000882
80000088000008800000000882
88888882222222222222222222