111111111111111222222222
100000001000001000000002
100000001000001000000002
100000000000001111011112
100000001000000000000002
100000001000000222222002
100000001000000200000002
100000001000000200000002
110011111111111200000002
200000000000000000000002
111111111111111200000002
000000000000000222222222