77777777777777771111117777
7111110d000000001000010007
71000000000000001000010007
71000000000000001000010007
7ddddddd000050001100110007
70000000000050000000000007
70000000000355000000000007
7000000000003000ddddddddd7
7000000000003000d000000007
1111111100000000d011111111
10000000000000000000000001
1000000100000000d010000001
11111111777777777711111111